____________________v
__SHHHHHHHHHHHHD____V
__V3_8_8_8_8_20AHHHHF
__V0__8_8_8__00__8___
__LHHHHHHHHHHKHHHHHD_
_3V_8___8____V40000V_
_0V___8___8__V00000V_
__AHHHHHHD___V00000V_
____8____V1__V8_8_8V_
__SHHHHHHJ0__V_8_8_V_
_3V___8__AHHHIHHHHHF3
_0AHHHHHHHHHHD___8__0




