_____________________
_8SHHHHHHHKHHHHHHHHD_
hHJ3__20__V_____8__V_
_8V0__00__LHHHHHHHHJ_
__LHHHHHHHJ40000___V_
__V______1V00000_20V_
__V1__8__0V00000_00V_
_3V0______V________V_
_0LHHHHHHHIHHHHHHHHJ_
__V20_8__3___8____1V_
__V00__8_0______8_0V_
__AHHHKHHHKHHHHKHHHF_
_____________________
