___v____8____________
__8LHHHHKHHHHHHD___18
_3_V_1__V______AD__0_
_0_V_0__V_3_____AHD_3
___V8___V_0_38___1V_0
___V_3__V___0____0V__
__3V_020LHHHD_8___V__
_30V__00V___AKHHHHJ__
_0_AHHHHJ_8__V____AD3
__40000_V__3_V__8_1V0
__00000_V8_0_V8___0V_
__00000_AHHHHIHHHKHF_