___8______________400
_______8_1SHHHHHD_000
__SHHHD__0V____1AD000
hHJ___V___V_20_0_V___
__V_1_AHHKF_00__8V_8_
__V_0__1_V_8__SHHID__
__V_8200_V__3_V___AKH
__V__00__AD_0_V_3_8V_
__AHD_____V___V_03_V_
____V_83__LHHHJ__0_V_
_1__V__0_SF__3AHHHHF_
_0__AHHHHF___0_______
