____________________D
__DLLLLLLLLLLLLL____D
__D____________ULLLLL
__D__________________
__SRRRRRRRRRRSRRRRRD_
__D__________D_____D_
__D__________D_____D_
__RRRRRRRD___D_____D_
_________D___D_____D_
__DLLLLLLL___D_____D_
__D______ULLLLLLLLLL_
__RRRRRRRRRRRD_______
_____________________
