_____________________
__RRRRRRRRSRRRRRRRRD_
RRV_______D________D_
__D_______SRRRRRRRRD_
__DLLLLLLLA________D_
__D_______D________D_
__D_______D________D_
__D_______D________D_
__DLLLLLLLHRRRRRRRRD_
__D________________D_
__D________________D_
__RRRRSRRRDLLLLALLLL_
_____________________