___D_________________
___SRRRRSRRRRRRD_____
___D____D______RD____
___D____D_______RRD__
___D____D_________D__
___D____D_________D__
___D____SRRRD_____D__
___D____D___RSRRRRD__
___RRRRRD____D____RD_
________D____D_____D_
________D____D_____D_
________RRRRRRRRRDLL_
_____________________