______________________
__________RRRRRRD_____
__RRRRD___U_____RD____
RRV___D___U______D____
__D___RRRSU______D____
__D______D____RRRRD___
__D______D____U___RRR_
__D______RD___U____U__
__RRD_____D___U____U__
____D_____RRRRV____U__
____D____RU___RRRRRU__
____RRRRRU____________
